NO ./textures/north_texture
SO ./textures/south_texture
WE ./textures/west_texture
EA ./textures/east_texture

F 220,100,35
C 225,30,0

        1111111111
        1000000001
111111111000000001
100000000000000001
10000N000000011111
10000000000001
11111111111111
